12 0 0 11 11
62223EB62223
400017740001
400015540001
400015540001
C888955C8889
7EAAA14AAAB7
DEAAA00AAABD
622235562223
400015540001
400015540001
40001DD40001
C8889EBC8889